statement:声明
sentence:句子
repeat:重复
grammarly:语法学
localization:本地化
excuse:原谅
slight:微小的
confusion:混乱
operator:操作
logical:逻辑的
trash:毁坏
instruction:命令
anyway:不管怎样
awareness:意识
quotient:商
terminate:终止
negative:消极的 负数 [ˈneɡətɪv] 
qualify:符合
race:比赛
mud tug of war:泥浆拔河
master:掌握
canoe:皮划艇
joust:竞争
reformat:改进
apparently:显然
digit:n 数字、数位 [ˈdɪdʒɪt] 
punctuation:标点符号
letter:字母
conditional:条件的
comfort :使舒适
alibi:托辞
lip ：嘴唇
nail:指甲
violet；蓝紫色
indigo；靛蓝色
automobile:汽车
precision:精确
handle： 处理
mismatch:错配
process: n、vt 过程, 处理 [ˈprɑːses , prəˈses]
reach:到达
donation:捐赠
carnivore:食肉动物
grand: 宏大的，n 一千美元
patrons: 资助者
volume: 体积
cube: 立方
probability：n 可能性 [ˌprɑːbəˈbɪləti] 
implementation：执行,实现 [ˌɪmpləmɛnˈteɪʃənz] 
correctly：正确地
odds：几率
prototype：n 原型 [ˈproʊtətaɪp]
preceding：在...之前
type cast: 类型转换 
propertise:财产,房地产
revaluation:再评价 [ˌriːvæljuˈeɪʃn]
factor: 因素，倍数
coordinates: 坐标系
horizontal: 水平的  [ˌhɔːrɪˈzɑːntl]
vertical：垂直的  [ˈvɜːrtɪkl] 
slick:取巧的
rectangular: 矩形的 [rekˈtæŋɡjələr]
polar:极线 
convert:转换 
seasons:季节 [ˈsiːznz]
expense: 开支  [ɪkˈspens]
fall:v落下 n秋天
recursion: 递归  [rɪˈkɜːrʒn] recursive：递归的
strategy：策略  [ˈstrætədʒi]
subdivide: 再分
estimate: v估算[ˈestɪmət] n  [ˈestɪmeɪt]
various:各种各样的[ˈveriəs] 
notations: 符号  [noʊˈteɪʃənz] 
signature: n 签名, 特征[ˈsɪɡnətʃər]
deduction:推理 [dɪˈdʌkʃn]
deprecated:已弃用[ˈdeprəkeɪtɪd]
represent：代表[ˌreprɪˈzent] 
encounter：遭遇 [ɪnˈkaʊntər]
reference: v/n 参考  [ˈrefrəns] 
swap: n/v 交换 [swɑːp]
evaluate: 评估 [ɪˈvæljueɪt]
temporary: 短暂的 [ˈtempəreri] 
accumulate: vt 积累  [əˈkjuːmjəleɪt] 
partial: adj 部分的 [ˈpɑːrʃl] 
initialization: n 初始化 [ɪˌnɪʃələˈzeɪʃn]
digits: n 数位  [ˈdɪdʒɪts] 
explicit: adj 明确的  [ɪkˈsplɪsɪt]
specialization: n 专业化  [ˌspeʃ(ə)lɪ'zeɪʃ(ə)n]
override: vt 推翻
instantiation: n 实例化 [ɪnˌstænʃiˈeɪʃən]
implicit: adj 隐式的 [ɪmˈplɪsɪt] 
scope: n范围 vt 仔细看 [skoʊp]
illustrate: v 解释 [ˈɪləstreɪtɪŋ]
external:adj 外部的[ɪkˈstɜːrnl]
compile: vt 编译 [kəmˈpaɪl]
linkage: n 连接  [ˈlɪŋkɪdʒ]
dispose: vt 处置 [dɪˈspoʊz]
chunk: n 大块  [tʃʌŋk]
heap:n 堆 [hiːp]
interactive: 互动的
solicit: v 请求
handicap: n 残疾，障碍
reminder: n 提醒 [rɪˈmaɪndər]
remaining: adj 剩下的[rɪˈmeɪnɪŋ]
gathers:v 收集  [ˈɡæðərz] 
quarters:n 四分之一,季度  [ˈkwɔːrtərz]
interactively: adv 交互式地 [ˌɪntərˈæktɪv]
semicolon: n 分号  [ˈsemikoʊlən] 
implement: v  使生效 [ˈɪmplɪment] 
abort: v 中止  [əˈbɔːrt]
transaction: n 交易  [trænˈzækʃn]
constructor: n 构造函数  [kənˈstrʌktər] 
destructor: n 析构函数   [dɪˈstrʌktər]
verbose: adj 冗长的  [vɜːrˈboʊs] 
augmented: adj 扩张的  [ɔːɡˈmentɪd] 
customize: v 订制  [ˈkʌstəmaɪzd] 
stack: n 堆栈  [stæk] 
formal: adj 正式的  [ˈfɔːrml]
format: vt 格式化  [ˈfɔːrmæt]
previous: adj 以前的  [ˈpriːviəs] 
revenue: n 收入  [ˈrevənuː]
invoking: v 调用  [ɪnˈvoʊkɪŋ]
draft: n 草稿  [dræft]
reverse: vt 颠倒  [rɪˈvɜːrs]
redion: n 弧度 [ˈreɪdiən]
generator: n 生成器 [ˈdʒenəreɪtər]
fractional: adj 分数的 [ˈfrækʃənl]
rear: n 队列尾部 [rɪə(r)]
nested：n、adj 嵌套的 [ˈnestɪd]
private: adj 私有的 [ˈpraɪvɪt]
front: n、adj 前面 [frʌnt]
current: adj 现在的 [ˈkɜːrənt]
queue: n 队列 [kjuː]
maximum: adj 最大的 [ˈmæksɪməm]
preemptive: adj 抢先的 [priˈɛmptɪv]
prevent: vt 防止 [prɪˈvent]
former: adj 以前的 [ˈfɔːrmər]
failure: n 失败 [ˈfeɪljər]
item: n 项目 [ˈaɪtəm]
method: n 方法 [ˈmeθəd]
simulator: n 模拟器  [ˈsɪmjuleɪtər]
cumulative: adj 累计的 [ˈkjuːmjəleɪtɪv] 
turn away: 拒绝 [tɜːrn əˈweɪ] 
infinity: n 无穷大  [ɪnˈfɪnəti]
purchase: n,vt 购买 [ˈpɜːrtʃəs] 
declaration: n 声明 [ˌdekləˈreɪʃn]
catalog: vt 记载 [ˈkætəlɔːɡ] 
preference: n 偏爱  [ˈprefrəns]
alternative: adj 可替代的 [ɔːlˈtɜːrnətɪv]
pick: n 选择 [pɪk] 
polar: n 极线 [ˈpoʊlər]
focal: adj 焦点的  [ˈfoʊkl] 
telescope：n 望远镜 [ˈtelɪskoʊp]
eyepiece：n 目镜  [ˈaɪˌpisɪz]
magnification： n 放大倍数 [ˌmæɡnɪfɪˈkeɪʃn]
square: vt 使成平方 [skwer] 
optional: adj 可选择的  [ˈɑːpʃənl]
remainder: n、adj 剩余 [rɪˈmeɪndər] 
derive：v 派生 [dɪˈraɪv]
deposit: n、v 存款 [dɪˈpɑːzɪt]
loan: n、v 借款  [loʊn] 
rate: n 速速、比率 vt 评估 [reɪt]
withdraw: v 取  [wɪðˈdrɔː]
exceed: v 超过 [ɪkˈsiːd] 
portion: n 部分 vt 划分成部分  [ˈpɔːrʃn]
polymorphic: adj 多态的  [ˌpɑˌliˈmɔrfɪk]
decimal: adj 十进制的 [ˈdesɪml]
invalid: adj 无效的 [ɪnˈvælɪd , ˈɪnvəlɪd]
abstract：adj 抽象的 [ˈæbstrækt , æbˈstrækt]
charge: n vt 收费 [tʃɑːrdʒ]
inheritance: n 继承 [ɪnˈherɪtəns]
blank：adj n 空白  [blæŋk] 
migrate: v 迁移 migration n 迁移  [ˈmaɪɡreɪt]
redirect: adj 重定向的  [ˌriːdəˈrekt , ˈriːdərekt] 
repository: n 仓库 [rɪˈpɑːzətɔːri]
execute: vt 执行  [ˈeksɪkjuːt]
hierarchy： n 等级制度 [ˈhaɪərɑːrki]
ambiguoous: adj 模棱两可的 [æmˈbɪɡjuəs]
fetch: v 拿来 [fetʃ] 
multiple: adj 多态的 [ˈmʌltɪpl]
multiply: vt 乘以 /ˈmʌltɪplaɪ/
category: n 种类  [ˈkætəɡɔːri]
kitchen: n 厨房 [ˈkɪtʃɪn]
diamond: n/adj 方块 [ˈdaɪəmənd]
club：n 梅花
spade: n 黑桃 [speɪd]
allocate：vt 分配 [ˈæləkeɪt]
superb: adj 极好的 [suːˈpɜːrb]
identification: n 识别 [aɪˌdentɪfɪˈkeɪʃn]
subscription: n 订阅 /səbˈskrɪpʃn/
lottery: n 彩票 /ˈlɑːtəri/
truncate: vt&adj 截断 /ˈtrʌŋkeɪt/
elephant: n 象 /ˈɛləfənt/
vector: n 矢量 /ˈvektər/
iterator: n 迭代器 /ɪtə'retɚ/
reprise: vt 重演 /rɪˈpriːz/
indicate: vt 表明 /ˈɪndɪkeɪt/
anonymous: adj 匿名的 /əˈnɑːnɪməs/
minus: prep 减 /ˈmaɪnəs/
island: n 岛 /ˈaɪlənd/
permutation: n 排列方式 /ˌpɜːrmjuˈteɪʃn/
algorithm: n 算法 /ˈælɡərɪðəm/
frequency: n 频率 /ˈfriːkwənsi/
extract: vt 提取 /ˈekstrækt , ɪkˈstrækt/
predicate: vt 断言 /ˈpredɪkət , ˈpredɪkeɪt/
premium: adj 优质的 /ˈpriːmiəm/
billing: n 账单 /ˈbɪlɪŋ/
omit: v 删除,遗漏 /əˈmɪt/
expire: v 失效 /ɪkˈspaɪər/
optimize：v 优化 /ˈɑːptɪmaɪz/
manipulator: n 操作者 /məˈnɪpjuleɪtər/
octal：adj 八进制
hexadecimal: adj 十六进制 /ˌheksəˈdesɪml/
precise: adj 精确的 /prɪˈsaɪs/
phase: n 阶段 /feɪz/
discard: v&n 丢弃 /dɪˈskɑːrd , ˈdɪskɑːrd/
trigger: vt&n 触发 /ˈtrɪɡər/
duplicate: vt&n 复制 /ˈduːplɪkət/
talent: n 人才；天赋 /ˈtælənt/
dynamic: adj 动态的
relay: vt 转发 /ˈriːleɪ/
simantics: n 含义，语义 /sɪˈmæntɪks/
interface: n 接口 /ˈɪntərfeɪs/
steal: vt 窃取 /stiːl/
application: n 应用 /ˌæplɪˈkeɪʃn/